7 8
WWWWWWWW
WE=====W
W======W
W======W
W======W
W=====SW
WWWWWWWW