8 8 Map 2
WWWWWWWW
W==WEWWW
W==W=W=W
W====W=W
W==WWW=W
W==W=W=W
W=====SW
WWWWWWWW