13 25
WWWWWWWWWWWWWWWWWWWWWWWWW
W=======================W
WWWWWWWWW=WWWWWWWWWWWWW=W
W=E==W=======W==========W
W====W=WWWWW=WW=WWWWWWWWW
W====W=W===W=W==========W
W====W=W=S=W=WWW=WWWWWWWW
W====W=W===W=W==========W
W====W=WW=WW=WWWWWWWWW=WW
W====W=======W==========W
W====WWWWWWWWW==========W
W=======================W
WWWWWWWWWWWWWWWWWWWWWWWWW

