25 23
WWWWWWWWWWWWWWWWWWWWWWW
W========WWWWWW=======W
W=WWW===W=====WW=WWWW=W
W======W======WW=WW===W
WWWW==W===WWW=W===W=W=W
W====W====W=W=W===W=W=W
W=WW======W=WWW==WW===W
W====W=WWWW=WWWWWW====W
W=WW=WWW=W============W
W=WW=WW======WW=W=WWW=W
WW=WSW===WWW=WW=WW==W=W
WW=W=W=W=WWWWWW=====W=W
W==W=====W=W==W=WW==W=W
W==WWWWWWW======W===W=W
W==WWWWWWWWWWWW=W=W=W=W
W====W====W=====WW==W=W
W=W=====W==W=W==W==WW=W
W=====W=W==WWWW=WW==W=W
WWWWW=W=W=====W==W=WW=W
W=====W=WWWW=====WWWWWW
W=====W==W=W==WWWW====W
W==E==W====W=====WWWW=W
W=====WWWWWWWWWW======W
W=====================W
WWWWWWWWWWWWWWWWWWWWWWW