20 26
WWWWWWWWWWWWWWWWWWWWWWWWWW
W======W=========W=======W
W======W=========W=======W
W======W=========W=======W
W========================W
W======W=========W=======W
W======W=========W=======W
W======W=========W=======W
WW=WWWWWWWW=WWWWWWWWWWWW=W
W======WWWWSWWWWWW=======W
WW=WWWWWWWWWWWWWWWW=WWWWWW
WW=WWWWW=========WW=WWWWWW
W======W=========W=======W
W======W=========W=======W
W======W====E====W=======W
W========================W
W======W=========W=======W
W======W=========W=======W
W======W=========W=======W
WWWWWWWWWWWWWWWWWWWWWWWWWW