31 71 Map 8
WWWWWWWWWWWWWWWWWWWWWWWWWWWWWWWWWWWWWWWWWWWWWWWWWWWWWWWWWWWWWWWWWWWWWWW
W======W======W=============W======W======W======W=============W======W
W=============W======W======W=============W=============W======W======W
W======W=============W=============W=============W======W======W======W
W=============W======W======W=============W=============W======W======W
W======W======W=============W======W======W======WWWWWWWW=============W
WWWW=WWWWWWWWWWWWWWWWWWWWWWWWWWWWWWWWWWWWWWWWWWWWWW====WWWWWWWWWWWW=WWW
W======W======W=============W======W======W======W======W======W==W=W=W
W======W======W======W======W=============W=============W======W==W===W
W======W=============W=============W=============W======W===========W=W
W======W======W======W======W=============W=============W======W==W===W
W======W======W=============W======W======W======WWWWWWWW======W==W=W=W
WWWW=WWWWWWWWWWWWWWWWWWWWWWWWWWWW=WWW=WW=WWWWWWWWW=W=W=WWWWWWWWWWWW=WWW
W======W======W======W======W====================W=============W======W
W=============W======W======W====================W=W=W=WW======W======W
W======W=============W======W====================W======W=============W
W======W======W=============W====================WWW=W=WW======W======W
W======W======W======W===========================W======W======W======W
WWWWWWWWWWWWWWWWWWWWWWWWWWWWW========E===========WW=W=W=WWWWWWWW=WWWWWW
W======W=============W======W====================WWWWWWWW======W======W
W======W======W======W======W====================W=============W======W
W==S===W======W======W======W===========================W======W======W
W======W======W======W===========================W=============W======W
W=============W======W======W====================W======W======W======W
WWW=WWWWWWWWWWWWWW=WWWWWWWWWWWWWWWWWWWWWWWWWWWWWWWWWWWWWWWWWWWWWWW=WWWW
W======W======W=============W======W======W======W=============W======W
W=============W======W======W=============W=============W======W======W
W======W=============W=============W=============W======W======W======W
W=============W======W======W=============W=============W======W======W
W======W======W=============W======W======W======W======W=============W
WWWWWWWWWWWWWWWWWWWWWWWWWWWWWWWWWWWWWWWWWWWWWWWWWWWWWWWWWWWWWWWWWWWWWWW