28 62
WWWWWWWWWWWWWWWWWWWWWWWWWWWWWWWWWWWWWWWWWWWWWWWWWWWWWWWWWWWWWW
W============================================================W
W============================================================W
W============================================================W
W============================================================W
W============================================================W
W============================================================W
W============================================================W
W============================================================W
W============================================================W
W============================================================W
W============================================================W
W============================================================W
W============================================================W
W============================S===============================W
W============================================================W
W============================================================W
W============================================================W
W============================================================W
W============================================================W
W============================================================W
W============================================================W
W============================================================W
W============================================================W
W============================================================W
W============================================================W
W============================================================W
WWWWWWWWWWWWWWWWWWWWWWWWWWWWWWWWWWWWWWWWWWWWWWWWWWWWWWWWWWWWWW