7 24 Welcome
========================
========W==W===W========
========W==W============
========WWWW===W========
========W==W===W========
========W==W===W========
========================
